NO assets/Frame-3_1.xpm
SO assets/Frame-1.xpm
WE assets/Frame-5-_2__1.xpm
EA assets/Frame-4_1.xpm

F 216,197,168
C 135,206,235

        1111111111111111111111111
        1000000000110000000000001
        1011000001110000000000001
        1001000000000000000000001
111111111011000001110000000000001
100000000011000001110111111111111
11110111111111011100000010001
11110111111111011101010010001
11000000110101011100000010001
10000000000000001100000010001
1000000000000000110101000000111
1100000111010101111101000N0001
11110111 1110101 10111101000111
11111111 1111111 111111111111
