NO assets/Frame-3_1.xpm
SO assets/Frame-6_1.xpm
WE assets/Frame-5-_2__1.xpm
EA assets/Frame-4_1.xpm

F 20,20,23

1111111
1000001
100E001
1000001
1111111


C 52,88,235
